####################
#f---#--------#----#
#-##-#-######-#-##-#
#-#--------------#-#
#-#-##-##  ##-##-#-#
#------#g bp#------#
#-#-##-######-##-#-#
#-#------p ------#-#
#-##-#-######-#-##-#
#----#--r-----#---f#
####################