####################
#    #        #    #
# ## # ###### # ## #
# #              # #
# # ## ##__## ## # #
#      #grba#      #
# # ## ###### ## # #
# #      p      -# #
# ## # ###### # ## #
#    #        #    #
####################
