####################
#f---#--------#----#
#-##-#-######-#-##-#
#-#--------------#-#
#-#-##-##  ##-##-#-#
#------# g  #------#
#-#-##-######-##-#-#
#-#------p ------#-#
#-##-#-######-#-##-#
#----#--------#---f#
####################