####################
#f---#--------#----#
#-##-#-######-#-##-#
#-#--------------#-#
#-#-##-##  ##-##-#-#
#------#grba#------#
#-#-##-######-##-#-#
#-#------p-------#-#
#-##-#-######-#-##-#
#----#--------#---f#
####################