####################
#f---#---r----#----#
#-##-#-######-#-##-#
#-#--------------#-#
#-#-##-##  ##-##-#-#
#------#g bp#------#
#-#-##-######-##-#-#
#-#------p ------#-#
#-##-#-######-#-##-#
#----#--------#---f#
####################