####################
#f---#--------#----#
#-##-#-######-#-##-#
#-#--------------#-#
#-#-##-##  ##-##-#-#
#------#    #------#
#-#-##-######-##-#-#
#-#--------------#-#
#-##-#-######-#-##-#
#----#--------#---f#
####################