####################
#f---#--------#----#
#-##-#-######-#-##-#
#-#--------------#-#
#-#-##-##  ##-##-#-#
#------#    #------#
#-#-##-######-##-#-#
#-#------  ------#-#
#-##-#-######-#-##-#
#----#--------#---f#
####################