####################
#f   #        #    #
# ## # ###### # ## #
# #              # #
# # ## ##__## ## # #
#      #grba#      #
# # ## ###### ## # #
# #      p     - # #
# ## # ###### # ## #
#    #        #   f#
####################
